11111111
110C01P1
1E010001
11111111