1111111111111111111111
1CCCCCCC0C111000CCCCC1
1CCCCCCCPC000E000CCCC1
1CCCCCCC1C000000CCCCC1
1CCCCCCC0C0000000CCCC1
1111111111111111111111
