111111111
1000C0001
1P00000E1
111111111