11111111
100E0P01
11111C11
11111111
11111111