11111111
101E0P01
11111C11
11111111
11111111
